3 13 31
###############################
#p   ** **    *               #
# # #x#*# # # # # # # # # # # #
#*     ** * *  *   * **   *   #
# # # # # #*# # # # # # #*# # #
#*   *s*    *** *   **        #
# # # # # # # # # # # # # #*# #
#    *     *        *    **   #
# #*# # #*#*#*#*# # # # # #*# #
#        *   * *    *   *     #
#*# # # # # # # # # # #*# # #*#
# *    * **    ** ***         #
###############################

